************************************************
*D                 *   *     *                 *
*      *********   *   **  *                   *
* ** *****        *    **  *************       *
*                 *    *** *        *    **    *
*                 *    *   *        *          *
*         *   *****    * * *        *** *** *  *
*         * *       *  *  **                   *
*         * *       *  **  * *******************
*         * *    * **  *  **                   *
*         *      *     **  *                   *
*         *      *         *                  A*
************************************************
