****************************************************************
*        *        *                                            *
*  ****  *  *******  ****************************  **********  *
*     *     *        *     *     *              *     *        *
****  *  ****  *******  *  *  *  *  **********  ****  *  *******
*     *  *     *        *     *  *        *  *  *     *     *  *
*  ****  *  ****  *******************  *******  **********  ****
*  *     *  *  *  *              *  *  *     *        *  *     *
*  *******  ****  *  **********  *  *  *  *  ****  *  *******  *
*        *  *     *     *     *  *  *     *     *  *           *
*  ****  *  *  *******  ****  *  *************  *  *************
*  *     *  *        *     *  *              *  *           *  *
*  *  ****  *************  *  *************  *  ****  ****  ****
*  *  *                    *              *  *     *  *  *     *
*  *  *  **********************  *******  ** ****  *  *  ****  *
*  *        *     *                    *  *     *  *     *     *
*  *******  *  *  *  ****  *******  *******  *  *  ****  *  ****
*  *        *  *  *     *        *  *        *  *  *  *  *     *
*  *  *******  *  ****  *  **********  **********  *  *  ****  *
*  *  *        *     *  *     *     *           *  *     *  *  *
*  *  *  *************  ****  *  *************  *  **********  *
*  *                       *  *     *  *  *     *        *  *  *
*  *  ****************************  *******  **********  ****  *
*  *        *     *  *        *  *  *  *              *  *     *
**********  *  *  *  *  ****  ****  ****  ****  *******  *  ****
*     *     *  *  *  *  *  *        *  *  *     *     *  *     *
*  ****  ****  *  *  *  ****************  *  ****  *  *  *******
*           *  *  *  *                 *  *  *     *  *        *
**********  ****  *  ****************  *  *  ****************  *
*D                *                 *     *              *     *
********************************************************** **************
                                                         *              *
*********************************************************************   *
*   *               *               *           *                   *   *
*   *   *********   *   *****   *********   *****   *****   *****   *   *
*               *       *   *           *           *   *   *       *   *
*********   *   *********   *********   *****   *   *   *   *********   *
*       *   *               *           *   *   *   *   *           *   *
*   *   *************   *   *   *********   *****   *   *********   *   *
*   *               *   *   *       *           *           *       *   *
*   *************   *****   *****   *   *****   *********   *   *****   *
*           *       *   *       *   *       *           *   *           *
*   *****   *****   *   *****   *   *********   *   *   *   *************
*       *       *   *   *       *       *       *   *   *       *       *
*************   *   *   *   *********   *   *****   *   *****   *****   *
*           *   *           *       *   *       *   *       *           *
*   *****   *   *********   *****   *   *****   *****   *************   *
*   *       *           *           *       *   *   *               *   *
*   *   *********   *   *****   *********   *   *   *************   *   *
*   *           *   *   *   *   *           *               *   *       *
*   *********   *   *   *   *****   *********   *********   *   *********
*   *       *   *   *           *           *   *       *               *
*   *   *****   *****   *****   *********   *****   *   *********   *   *
*   *                   *           *               *               *   *
*                                                                       *
*   *               *               *           *                   *   *
*   *   *********   *   *****   *********   *****   *****   *****   *   *
*               *       *   *           *           *   *   *       *   *
*********   *   *********   *********   *****   *   *   *   *********   *
*       *   *               *           *   *   *   *   *           *   *
*   *   *************   *   *   *********   *****   *   *********   *   *
*   *               *   *   *       *           *           *       *   *
*   *************   *****   *****   *   *****   *********   *   *****   *
*           *       *   *       *   *       *           *   *           *
*   *****   *****   *   *****   *   *********   *   *   *   *************
*       *       *   *   *       *       *       *   *   *       *       *
*************   *   *   *   *********   *   *****   *   *****   *****   *
*           *   *           *       *   *       *   *       *           *
*   *****   *   *********   *****   *   *****   *****   *************   *
*   *       *           *           *       *   *   *               *   *
*   *   *********   *   *****   *********   *   *   *************   *   *
*   *           *   *   *   *   *           *               *   *       *
*   *********   *   *   *   *****   *********   *********   *   *********
*   *       *   *   *           *           *   *       *               *
*   *   *****   *****   *****   *********   *****   *   *********   *   *
*   *                   *           *               *               *   *
** ****************** ************************ **************************
** ****************** ************************ *****************
*        *        *                                            *
*  ****  *  *******  ****************************  **********  *
*     *     *        *     *     *              *     *        *
****  *  ****  *******  *  *  *  *  **********  ****  *  *******
*     *  *     *        *     *  *        *  *  *     *     *  *
*  ****  *  ****  *******************  *******  **********  ****
*  *     *  *  *  *              *  *  *     *        *  *     *
*  *******  ****  *  **********  *  *  *  *  ****  *  *******  *
*        *  *     *     *     *  *  *     *     *  *           *
*  ****  *  *  *******  ****  *  *************  *  *************
*  *     *  *        *     *  *              *  *           *  *
*  *  ****  *************  *  *************  *  ****  ****  ****
*  *  *                    *              *  *     *  *  *     *
*  *  *  **********************  *******  ** ****  *  *  ****  *
*  *        *     *                    *  *     *  *     *     *
*  *******  *  *  *  ****  *******  *******  *  *  ****  *  ****
*  *        *  *  *     *        *  *        *  *  *  *  *     *
*  *  *******  *  ****  *  **********  **********  *  *  ****  *
*  *  *        *     *  *     *     *           *  *     *  *  *
*  *  *  *************  ****  *  *************  *  **********  *
*  *                       *  *     *  *  *     *        *  *  *
*  *  ****************************  *******  **********  ****  *
*  *        *     *  *        *  *  *  *              *  *     *
**********  *  *  *  *  ****  ****  ****  ****  *******  *  ****
*     *     *  *  *  *  *  *        *  *  *     *     *  *     *
*  ****  ****  *  *  *  ****************  *  ****  *  *  *******
*           *  *  *  *                 *  *  *     *  *        *
**********  ****  *  ****************  *  *  ****************  *
*                 *                 *     *              *     *
********************************************************** **************
                                                         *              *
*********************************************************************   *
*   *               *               *           *                   *   *
*   *   *********   *   *****   *********   *****   *****   *****   *   *
*               *       *   *           *           *   *   *       *   *
*********   *   *********   *********   *****   *   *   *   *********   *
*       *   *               *           *   *   *   *   *           *   *
*   *   *************   *   *   *********   *****   *   *********   *   *
*   *               *   *   *       *           *           *       *   *
*   *************   *****   *****   *   *****   *********   *   *****   *
*           *       *   *       *   *       *           *   *           *
*   *****   *****   *   *****   *   *********   *   *   *   *************
*       *       *   *   *       *       *       *   *   *       *       *
*************   *   *   *   *********   *   *****   *   *****   *****   *
*           *   *           *       *   *       *   *       *           *
*   *****   *   *********   *****   *   *****   *****   *************   *
*   *       *           *           *       *   *   *               *   *
*   *   *********   *   *****   *********   *   *   *************   *   *
*   *           *   *   *   *   *           *               *   *       *
*   *********   *   *   *   *****   *********   *********   *   *********
*   *       *   *   *           *           *   *       *               *
*   *   *****   *****   *****   *********   *****   *   *********   *   *
*   *                   *           *               *               *   *
*                                                                       *
*   *               *               *           *                   *   *
*   *   *********   *   *****   *********   *****   *****   *****   *   *
*               *       *   *           *           *   *   *       *   *
*********   *   *********   *********   *****   *   *   *   *********   *
*       *   *               *           *   *   *   *   *           *   *
*   *   *************   *   *   *********   *****   *   *********   *   *
*   *               *   *   *       *           *           *       *   *
*   *************   *****   *****   *   *****   *********   *   *****   *
*           *       *   *       *   *       *           *   *           *
*   *****   *****   *   *****   *   *********   *   *   *   *************
*       *       *   *   *       *       *       *   *   *       *       *
*************   *   *   *   *********   *   *****   *   *****   *****   *
*           *   *           *       *   *       *   *       *           *
*   *****   *   *********   *****   *   *****   *****   *************   *
*   *       *           *           *       *   *   *               *   *
*   *   *********   *   *****   *********   *   *   *************   *   *
*   *           *   *   *   *   *           *               *   *       *
*   *********   *   *   *   *****   *********   *********   *   *********
*   *       *   *   *           *           *   *       *               *
*   *   *****   *****   *****   *********   *****   *   *********   *   *
* A *                   *           *               *               *   *
*************************************************************************
