**********************************
*D                               *
*            *                   *
*            *                   *
*            *                   *
*   **********                   *
*                               A*
**********************************