**********************************
*D                               *
*            *                   *
*            *                   *
*            *                   *
**************                   *
*                               A*
**********************************