**********************************
*D                            *  *
*                             *  *
*                             *  *
*                             *  *
*****************************    *
*A                               *
**********************************