**********************************
*D               *               *
*            *   *  *            *
*            *   *  *            *
*            *   *  *            *
*   **********   *  *            *
*                   *           A*
**********************************